x
x
0002000200020002000200020000
x
0002000200020002000200020000
0000000000000100000000000000
0002000200020002000200020000
x
0002000200000000000200020000
x
0000000000020002000000000000
x
0000000000020002000000000000
6000020200000000000202000060
5000000000000000000000000050
x
0000000000020002000000000000
0002000200000100000200020000
0000000000020002000000000000
0002000200000000000200020000
0000000000060006000000000000
0002000200000000000200020000
x
0006000600006060000600060000
0000000000004004000000000000
x